3333333333333333333333333
3044345554455545554444553
3435343534353434353535353
3445555544444444555545443
3435343534343534353435343
3555555544445554545455553
3534353434343535353534343
3554455445544455545454453
3434343434343435343534353
3444434543554344434543543
3443554345434443444345543
3435343535343435343535353
3554445545544455544545443
3534343434343434343534403
3333333333333333333333333